2222222222222222222222222222222
2222222111111111111111112122222
2122212122212222222122212122212
2121111121111112111111211111212
2111222121222212122221212221112
2221211121211111111121211121222
2111212221212222222121222121112
2122211111112555552111111122212
2111212221212222222121222121112
2221211121211111111121211121222
2111222121222212122221212221112
2121111121111112111111211111212
2122212122212222222122212122212
2222222111111112111111112222222
2222222222222222222222222222222